1 2 3 4 5 6 7 8 1 4 5 6 9 10 11 4 5 6 12 13 14 15 16 17 1 18 19 20 5 21 22 17 1 18 19 20 5 21 22 17 1 4 23 24 9 10 25 26
27 28 29 30 31 32 33 34 27 30 31 32 35 36 37 30 31 32 38 39 40 41 42 43 27 30 44 45 31 32 46 43 27 30 44 45 31 32 46 43 27 30 47 48 35 49 50 26
1 4 7 8 31 32 1 18 3 4 31 32 51 51 1 4 31 32 52 53 7 54 1 4 5 6 55 20 31 32 56 17 5 6 55 20 31 32 56 17 5 6 12 13 51 51 25 26
27 30 33 34 57 58 27 59 29 30 31 32 51 51 27 30 31 32 60 61 62 34 27 30 31 32 44 45 31 32 46 43 31 32 44 45 31 32 46 43 31 32 38 39 51 51 50 26
63 64 65 65 66 65 67 68 69 70 31 32 51 51 1 4 31 32 71 72 1 18 3 4 31 32 1 4 31 32 1 4 31 32 1 4 31 32 9 73 31 32 74 72 51 51 75 76
77 77 77 77 77 77 77 78 79 80 57 58 51 51 27 30 57 58 81 82 27 59 29 30 31 32 27 30 31 32 27 30 31 32 27 30 31 32 83 49 31 32 81 82 51 51 75 84
12 13 1 4 5 6 14 85 78 86 87 65 63 64 65 65 66 65 67 68 69 70 1 4 31 32 1 4 31 32 1 4 31 32 1 4 31 32 7 8 31 32 88 89 90 91 75 92
38 39 27 30 31 32 40 93 77 77 77 77 77 77 77 77 77 77 77 78 79 94 95 30 31 32 27 30 31 32 27 30 31 32 27 30 31 32 33 34 31 32 96 97 98 77 77 77
74 72 1 4 31 32 1 4 9 99 31 100 7 8 31 100 7 8 14 85 78 101 69 70 31 32 1 4 31 32 1 4 31 32 1 4 31 32 1 4 31 32 102 98 103 104 25 26
81 82 27 30 31 105 27 30 106 49 31 105 33 34 31 105 33 34 40 93 107 78 79 80 31 105 27 30 31 105 27 30 31 105 27 30 31 105 27 30 31 105 77 77 108 109 50 26
63 64 63 64 110 111 63 64 63 64 110 111 63 64 110 111 63 64 63 64 63 64 78 112 113 111 63 64 110 111 63 64 110 111 63 64 110 111 63 64 110 111 63 64 63 64 114 26
77 77 77 77 77 77 77 77 77 77 77 77 77 77 77 77 77 77 77 77 77 77 77 77 77 77 77 77 77 77 77 77 77 77 77 77 77 77 77 77 77 77 77 77 77 77 77 77
