1 2 3 4 2 2 2 2 5 6 7 8 9 4 10 11 
1 2 12 13 2 2 2 2 14 15 16 17 12 13 1 1
1 2 12 13 2 2 5 6 15 2 18 19 12 13 1 1 
1 2 12 13 2 2 20 15 2 2 21 22 12 13 1 1
1 1 23 24 5 6 25 17 26 27 28 29 12 13 1 1 
1 1 30 11 31 32 33 34 35 35 2 2 12 13 1 1
1 1 3 4 36 37 2 2 2 2 2 2 23 24 1 1 
1 1 12 13 21 38 39 2 2 2 40 1 30 11 1 1
41 8 12 13 28 29 2 2 5 6 15 2 42 8 1 1 
43 44 12 13 2 2 2 2 14 15 2 2 16 17 1 1
45 46 23 24 47 17 5 6 48 27 26 27 49 50 1 1
51 33 30 11 33 34 31 32 35 35 35 35 33 34 1 1
