1 1 1 1 2 3 4 4 5 6 4 4 7 8 9 10 1 1 1 1 1 1 1 1 1 1 1 1 1 1 1 1 1 1 1 1 1 1 1 1 1 1 1 1 11 12 13 14
1 1 15 16 17 2 18 19 20 21 22 22 7 23 24 25 15 16 15 16 26 16 15 16 4 27 27 27 26 16 27 27 15 16 15 16 27 27 15 16 27 27 26 16 28 29 13 14
1 1 30 31 32 33 2 34 4 4 22 22 7 23 35 36 30 31 11 12 37 38 30 31 39 40 11 12 37 38 9 41 30 31 11 12 42 38 43 40 11 12 37 38 44 45 13 14
1 1 46 47 22 22 17 2 18 22 22 18 7 23 48 49 46 30 28 29 29 50 46 30 20 21 28 29 29 50 24 25 46 51 28 29 29 50 20 21 28 29 29 50 52 53 13 14
1 1 4 32 22 22 32 33 2 34 39 54 7 23 30 55 56 6 29 29 29 29 56 6 16 31 57 29 58 59 35 36 4 32 57 29 29 29 16 31 29 29 29 29 30 31 13 14
1 1 22 18 22 22 18 18 60 2 20 61 7 23 62 30 63 21 64 65 66 59 67 21 46 30 68 29 69 69 48 49 22 19 68 29 70 29 46 30 64 65 66 59 46 47 13 14
1 1 39 6 22 22 1 1 1 1 1 1 7 23 44 71 16 31 44 45 58 72 16 31 56 6 73 29 69 69 30 55 22 19 73 29 74 29 56 6 29 29 69 69 4 32 1 1
1 1 20 75 22 22 15 16 15 76 15 16 7 23 52 53 46 30 52 53 69 69 46 51 20 21 77 29 69 69 46 30 22 78 77 29 77 29 20 21 64 79 69 69 22 22 69 80
1 1 1 1 81 22 43 6 4 32 30 31 7 23 30 31 56 54 1 1 16 82 4 32 4 4 1 1 16 82 56 6 22 22 30 31 30 31 16 31 30 31 83 4 22 22 69 84
1 1 15 76 18 18 20 75 22 22 46 47 7 23 46 51 20 21 15 76 46 47 22 22 22 22 15 76 46 51 20 21 22 22 46 47 46 47 46 47 46 47 18 18 18 18 69 85
1 1 4 32 1 1 1 1 86 18 27 87 7 23 27 87 27 27 27 87 27 87 18 18 18 18 27 87 27 87 27 27 18 18 27 87 27 87 27 87 27 87 1 1 1 1 1 1
88 88 89 89 90 91 90 91 88 88 88 88 88 88 88 88 88 88 88 88 88 88 88 88 88 88 88 88 88 88 88 88 88 88 88 88 88 88 88 88 88 88 88 88 88 88 88 88
