1 1 2 3 4 4 4 4 2 3 5 5 5 5 5 5 5 5 5 5 5 5 5 5 5 5 5 5 5 5 5 5 5 5 5 5 5 5 5 5 5 5 5 5 5 5 1 1
1 1 6 7 8 8 8 9 6 10 5 5 5 5 5 5 5 5 5 5 5 5 5 5 5 5 5 5 5 5 5 5 5 5 5 5 5 5 5 5 5 5 5 5 5 5 1 1
1 1 4 11 8 8 12 13 4 14 5 5 5 5 5 5 4 15 4 15 5 5 5 5 5 5 5 5 16 17 5 5 5 5 5 5 5 5 5 5 5 5 4 15 4 15 1 1
1 1 8 8 8 18 19 20 8 18 5 5 5 5 5 5 9 21 9 21 5 5 5 5 5 5 5 5 22 23 5 5 5 5 5 5 5 5 5 5 24 25 8 21 8 4 1 1
1 1 8 8 8 26 27 28 29 18 5 5 5 5 16 17 30 31 32 33 16 17 5 5 5 5 5 5 34 35 4 15 4 15 4 15 4 15 36 25 37 37 12 13 8 8 1 1
1 1 8 8 8 9 6 38 9 9 5 5 5 5 39 23 40 5 5 41 22 42 5 5 5 5 5 5 43 21 8 4 8 4 9 21 9 4 37 37 37 37 44 45 8 8 37 46
1 1 8 8 12 13 47 35 1 1 5 5 32 33 1 1 5 5 5 5 11 11 16 17 16 17 4 15 48 49 9 9 8 8 1 1 50 51 27 52 53 13 4 4 9 9 37 54
1 1 8 18 44 55 43 4 1 1 56 5 5 41 4 21 57 58 5 59 8 8 22 60 22 23 9 21 61 62 1 1 8 8 63 27 64 50 65 10 44 45 8 8 1 1 37 66
1 1 8 8 47 35 4 8 4 67 36 25 36 25 12 13 27 52 38 28 29 8 11 11 34 35 1 1 68 52 16 17 8 8 30 31 32 33 50 69 4 4 9 9 27 52 1 1
1 1 9 70 71 21 8 9 8 9 37 37 37 37 44 45 65 38 65 38 9 9 9 70 71 4 63 27 65 38 22 60 8 18 40 5 5 41 64 50 9 9 1 1 6 7 1 1
1 1 1 1 72 1 12 13 12 73 1 1 1 1 1 1 1 1 1 1 16 17 1 1 4 18 5 5 1 1 74 74 9 9 5 5 16 17 1 1 1 1 4 4 4 11 1 1
1 1 1 1 75 76 44 77 44 45 21 21 63 27 63 27 63 27 21 21 39 23 63 27 9 9 57 58 63 27 1 1 1 1 57 58 39 23 63 27 63 27 9 9 9 9 1 1
